__TT_T____
TTTT_TTTTT
___T__T___
__TT__TTTT
_________T
TTTT__T__T
_____X____
__________
